//MAP CONVERTED BY dmm2tgm.py THIS HEADER COMMENT PREVENTS RECONVERSION, DO NOT REMOVE
"a" = (
/turf/open/floor/mineral/titanium,
/area/shuttle/arrival)
"c" = (
/obj/structure/chair/comfy/shuttle{
	dir = 4
	},
/turf/open/floor/mineral/titanium,
/area/shuttle/arrival)
"f" = (
/obj/structure/shuttle/engine/propulsion{
	dir = 8
	},
/obj/structure/window/reinforced{
	dir = 1
	},
/turf/open/space/basic,
/area/shuttle/arrival)
"g" = (
/obj/structure/window/reinforced{
	dir = 8
	},
/turf/open/floor/mineral/titanium/blue,
/area/shuttle/arrival)
"h" = (
/obj/structure/chair/comfy/shuttle{
	dir = 1
	},
/turf/open/floor/mineral/titanium,
/area/shuttle/arrival)
"j" = (
/obj/machinery/door/airlock/titanium{
	name = "Emergency Shuttle Airlock"
	},
/turf/open/floor/mineral/titanium,
/area/shuttle/arrival)
"k" = (
/obj/machinery/computer/arcade,
/turf/open/floor/mineral/titanium/blue,
/area/shuttle/arrival)
"l" = (
/obj/machinery/door/airlock/titanium{
	name = "Emergency Shuttle Cargo"
	},
/turf/open/floor/mineral/titanium/blue,
/area/shuttle/arrival)
"m" = (
/obj/effect/spawner/structure/window/shuttle,
/turf/open/floor/plating,
/area/shuttle/arrival)
"n" = (
/obj/structure/chair/comfy/shuttle{
	dir = 1
	},
/turf/open/floor/mineral/titanium/blue,
/area/shuttle/arrival)
"o" = (
/obj/structure/chair/comfy/shuttle,
/obj/structure/window/reinforced{
	dir = 8
	},
/turf/open/floor/mineral/titanium,
/area/shuttle/arrival)
"p" = (
/turf/closed/wall/mineral/titanium,
/area/shuttle/arrival)
"q" = (
/obj/structure/shuttle/engine/propulsion{
	dir = 8
	},
/obj/structure/window/reinforced,
/turf/open/space/basic,
/area/shuttle/arrival)
"r" = (
/obj/structure/chair/comfy/shuttle{
	dir = 8
	},
/turf/open/floor/mineral/titanium,
/area/shuttle/arrival)
"w" = (
/obj/structure/chair/comfy/shuttle{
	dir = 8
	},
/obj/machinery/requests_console{
	department = "Arrival shuttle";
	name = "Arrivals Shuttle console";
	pixel_y = 30
	},
/turf/open/floor/mineral/titanium,
/area/shuttle/arrival)
"y" = (
/obj/structure/chair/comfy/shuttle{
	dir = 4
	},
/turf/open/floor/mineral/titanium/blue,
/area/shuttle/arrival)
"z" = (
/turf/template_noop,
/area/template_noop)
"C" = (
/obj/structure/chair/comfy/shuttle{
	dir = 4
	},
/obj/machinery/requests_console{
	department = "Arrival shuttle";
	name = "Arrivals Shuttle console";
	pixel_y = 30
	},
/turf/open/floor/mineral/titanium,
/area/shuttle/arrival)
"H" = (
/obj/structure/shuttle/engine/heater{
	dir = 8
	},
/obj/structure/window/reinforced,
/obj/structure/window/reinforced{
	dir = 4
	},
/turf/closed/wall/mineral/titanium,
/area/shuttle/arrival)
"I" = (
/turf/open/floor/mineral/titanium/blue,
/area/shuttle/arrival)
"J" = (
/obj/structure/chair/comfy/shuttle{
	dir = 1
	},
/obj/structure/window/reinforced{
	dir = 8
	},
/turf/open/floor/mineral/titanium,
/area/shuttle/arrival)
"M" = (
/obj/item/radio/intercom{
	name = "Station Intercom (General)";
	pixel_y = -29
	},
/turf/open/floor/mineral/titanium/blue,
/area/shuttle/arrival)
"N" = (
/obj/structure/shuttle/engine/heater{
	dir = 8
	},
/obj/structure/window/reinforced{
	dir = 4
	},
/obj/structure/window/reinforced{
	dir = 1
	},
/turf/closed/wall/mineral/titanium,
/area/shuttle/arrival)
"W" = (
/obj/structure/closet/emcloset,
/turf/open/floor/mineral/titanium,
/area/shuttle/arrival)
"X" = (
/obj/effect/spawner/structure/window/shuttle,
/obj/docking_port/mobile/arrivals,
/turf/open/floor/plating,
/area/shuttle/arrival)
"Y" = (
/obj/structure/chair/comfy/shuttle,
/turf/open/floor/mineral/titanium,
/area/shuttle/arrival)

(1,1,1) = {"
q
z
z
z
f
"}
(2,1,1) = {"
H
z
z
z
N
"}
(3,1,1) = {"
p
o
g
J
p
"}
(4,1,1) = {"
p
k
I
n
p
"}
(5,1,1) = {"
p
Y
I
h
p
"}
(6,1,1) = {"
p
p
l
p
p
"}
(7,1,1) = {"
p
c
I
c
p
"}
(8,1,1) = {"
j
I
I
a
m
"}
(9,1,1) = {"
p
w
a
r
p
"}
(10,1,1) = {"
p
m
m
m
p
"}
(11,1,1) = {"
p
C
a
c
p
"}
(12,1,1) = {"
j
I
I
a
m
"}
(13,1,1) = {"
p
r
I
r
p
"}
(14,1,1) = {"
p
p
l
p
p
"}
(15,1,1) = {"
p
W
I
a
p
"}
(16,1,1) = {"
p
Y
I
h
p
"}
(17,1,1) = {"
p
I
I
M
p
"}
(18,1,1) = {"
p
a
y
a
p
"}
(19,1,1) = {"
p
m
X
m
p
"}
