//MAP CONVERTED BY dmm2tgm.py THIS HEADER COMMENT PREVENTS RECONVERSION, DO NOT REMOVE
"aj" = (
/obj/structure/shuttle/engine/heater{
	dir = 8
	},
/obj/structure/window/reinforced{
	dir = 4
	},
/turf/open/floor/plating/airless,
/area/ruin/space/has_grav/whiteship/box)
"aL" = (
/obj/structure/bed,
/obj/item/bedsheet,
/obj/structure/window/reinforced,
/obj/structure/window/reinforced{
	dir = 4
	},
/turf/open/floor/mineral/titanium/purple,
/area/ruin/space/has_grav/whiteship/box)
"bm" = (
/obj/structure/light_construct/small{
	dir = 1
	},
/turf/open/floor/plating,
/area/ruin/space/has_grav/whiteship/box)
"cZ" = (
/obj/item/shard{
	icon_state = "medium"
	},
/turf/open/floor/mineral/titanium/white,
/area/ruin/space/has_grav/whiteship/box)
"dn" = (
/obj/structure/frame/computer{
	anchored = 1;
	dir = 1
	},
/obj/structure/light_construct,
/turf/open/floor/mineral/titanium/white,
/area/ruin/space/has_grav/whiteship/box)
"gs" = (
/obj/machinery/computer/pod{
	dir = 8;
	id = "oldship_ruin_gun"
	},
/turf/open/floor/mineral/titanium/white,
/area/ruin/space/has_grav/whiteship/box)
"jo" = (
/obj/structure/frame/computer{
	anchored = 1;
	dir = 8
	},
/turf/open/floor/mineral/titanium/white,
/area/ruin/space/has_grav/whiteship/box)
"kB" = (
/obj/structure/shuttle/engine/propulsion/left{
	dir = 8
	},
/turf/open/floor/plating/airless,
/area/ruin/space/has_grav/whiteship/box)
"kK" = (
/obj/item/multitool,
/turf/open/floor/mineral/titanium/white,
/area/ruin/space/has_grav/whiteship/box)
"lk" = (
/obj/structure/table,
/obj/item/gps/mining{
	gpstag = "Distant Signal"
	},
/turf/open/floor/mineral/titanium/white,
/area/ruin/space/has_grav/whiteship/box)
"lm" = (
/obj/machinery/mass_driver{
	dir = 4;
	icon_state = "mass_driver";
	id = "oldship_ruin_gun"
	},
/turf/open/floor/plating,
/area/ruin/space/has_grav/whiteship/box)
"lw" = (
/obj/machinery/door/airlock/titanium,
/turf/open/floor/plating,
/area/ruin/space/has_grav/whiteship/box)
"mo" = (
/obj/machinery/sleeper{
	dir = 8
	},
/obj/effect/decal/remains/human,
/obj/structure/light_construct,
/turf/open/floor/mineral/titanium/white,
/area/ruin/space/has_grav/whiteship/box)
"nF" = (
/obj/structure/chair{
	dir = 1
	},
/turf/open/floor/mineral/titanium/white,
/area/ruin/space/has_grav/whiteship/box)
"oo" = (
/obj/item/stock_parts/cell{
	charge = 100;
	maxcharge = 15000
	},
/turf/open/floor/mineral/titanium/white,
/area/ruin/space/has_grav/whiteship/box)
"ot" = (
/obj/structure/chair{
	dir = 4
	},
/obj/effect/decal/remains/human,
/turf/open/floor/mineral/titanium/white,
/area/ruin/space/has_grav/whiteship/box)
"oF" = (
/turf/open/floor/plating,
/area/ruin/space/has_grav/whiteship/box)
"pl" = (
/obj/structure/bed,
/obj/item/bedsheet,
/obj/structure/window/reinforced{
	dir = 1
	},
/obj/structure/window/reinforced{
	dir = 8
	},
/turf/open/floor/mineral/titanium/purple,
/area/ruin/space/has_grav/whiteship/box)
"uW" = (
/obj/structure/rack,
/obj/item/tank/internals/emergency_oxygen,
/obj/item/tank/internals/emergency_oxygen,
/obj/item/tank/internals/emergency_oxygen,
/obj/item/tank/internals/emergency_oxygen,
/obj/item/storage/toolbox/mechanical,
/turf/open/floor/mineral/titanium/white,
/area/ruin/space/has_grav/whiteship/box)
"vq" = (
/obj/machinery/portable_atmospherics/canister/oxygen,
/turf/open/floor/mineral/titanium/white,
/area/ruin/space/has_grav/whiteship/box)
"yH" = (
/obj/structure/light_construct/small{
	dir = 8
	},
/turf/open/floor/mineral/titanium/white,
/area/ruin/space/has_grav/whiteship/box)
"zf" = (
/obj/structure/light_construct/small{
	dir = 4
	},
/turf/open/floor/mineral/titanium/white,
/area/ruin/space/has_grav/whiteship/box)
"Al" = (
/turf/open/floor/mineral/titanium/white,
/area/ruin/space/has_grav/whiteship/box)
"DB" = (
/obj/machinery/computer{
	desc = "A computer long since rendered non-functional due to lack of maintenance. Spitting out error messages.";
	name = "Broken Computer"
	},
/turf/open/floor/mineral/titanium/white,
/area/ruin/space/has_grav/whiteship/box)
"EZ" = (
/turf/template_noop,
/area/template_noop)
"Ft" = (
/obj/structure/table,
/obj/item/gun/energy/laser/retro,
/turf/open/floor/mineral/titanium/white,
/area/ruin/space/has_grav/whiteship/box)
"Gv" = (
/obj/structure/light_construct,
/turf/open/floor/mineral/titanium/white,
/area/ruin/space/has_grav/whiteship/box)
"HW" = (
/obj/structure/frame/computer{
	anchored = 1
	},
/obj/machinery/light{
	dir = 1
	},
/turf/open/floor/mineral/titanium/white,
/area/ruin/space/has_grav/whiteship/box)
"Ii" = (
/obj/effect/spawner/structure/window/shuttle,
/turf/open/floor/plating,
/area/ruin/space/has_grav/whiteship/box)
"Ip" = (
/obj/machinery/door/airlock/titanium,
/turf/open/floor/mineral/titanium/white,
/area/ruin/space/has_grav/whiteship/box)
"Jy" = (
/obj/structure/light_construct{
	dir = 4
	},
/turf/open/floor/mineral/titanium/white,
/area/ruin/space/has_grav/whiteship/box)
"JF" = (
/obj/machinery/door/poddoor{
	id = "oldship_ruin_gun";
	name = "pod bay door"
	},
/turf/open/floor/plating,
/area/ruin/space/has_grav/whiteship/box)
"JG" = (
/obj/structure/rack,
/obj/item/clothing/suit/space/hardsuit/medical,
/obj/item/clothing/mask/breath,
/turf/open/floor/mineral/titanium/white,
/area/ruin/space/has_grav/whiteship/box)
"Ko" = (
/obj/structure/table,
/obj/item/radio/off,
/turf/open/floor/mineral/titanium/white,
/area/ruin/space/has_grav/whiteship/box)
"LS" = (
/turf/closed/wall/mineral/titanium,
/area/ruin/space/has_grav/whiteship/box)
"LT" = (
/obj/structure/chair,
/turf/open/floor/mineral/titanium/white,
/area/ruin/space/has_grav/whiteship/box)
"Mq" = (
/obj/machinery/door/airlock/public/glass,
/turf/open/floor/plating,
/area/ruin/space/has_grav/whiteship/box)
"Mw" = (
/obj/structure/light_construct{
	dir = 1
	},
/turf/open/floor/mineral/titanium/white,
/area/ruin/space/has_grav/whiteship/box)
"On" = (
/obj/structure/table,
/turf/open/floor/mineral/titanium/white,
/area/ruin/space/has_grav/whiteship/box)
"ON" = (
/obj/structure/shuttle/engine/propulsion{
	dir = 8
	},
/turf/open/floor/plating/airless,
/area/ruin/space/has_grav/whiteship/box)
"Pb" = (
/obj/machinery/door/window/northright,
/obj/effect/decal/remains/human,
/turf/open/floor/mineral/titanium/purple,
/area/ruin/space/has_grav/whiteship/box)
"PE" = (
/obj/machinery/portable_atmospherics/scrubber,
/turf/open/floor/mineral/titanium/white,
/area/ruin/space/has_grav/whiteship/box)
"Qn" = (
/obj/structure/light_construct{
	dir = 8
	},
/turf/open/floor/mineral/titanium/white,
/area/ruin/space/has_grav/whiteship/box)
"QE" = (
/obj/machinery/door/window,
/turf/open/floor/mineral/titanium/purple,
/area/ruin/space/has_grav/whiteship/box)
"Ry" = (
/obj/item/scalpel,
/turf/open/floor/mineral/titanium/white,
/area/ruin/space/has_grav/whiteship/box)
"Tv" = (
/obj/machinery/door/airlock/public/glass,
/turf/open/floor/mineral/titanium/white,
/area/ruin/space/has_grav/whiteship/box)
"TB" = (
/obj/structure/table,
/obj/item/storage/firstaid/regular{
	pixel_x = 6;
	pixel_y = -5
	},
/turf/open/floor/mineral/titanium/white,
/area/ruin/space/has_grav/whiteship/box)
"Ui" = (
/turf/closed/wall/mineral/titanium/interior,
/area/ruin/space/has_grav/whiteship/box)
"Uj" = (
/obj/structure/shuttle/engine/propulsion/right{
	dir = 8
	},
/turf/open/floor/plating/airless,
/area/ruin/space/has_grav/whiteship/box)
"VL" = (
/obj/structure/table,
/obj/item/tank/internals/oxygen,
/turf/open/floor/mineral/titanium/white,
/area/ruin/space/has_grav/whiteship/box)
"VO" = (
/obj/structure/table,
/obj/item/screwdriver,
/obj/structure/light_construct{
	dir = 1
	},
/turf/open/floor/mineral/titanium/white,
/area/ruin/space/has_grav/whiteship/box)
"XU" = (
/obj/structure/light_construct/small,
/turf/open/floor/plating,
/area/ruin/space/has_grav/whiteship/box)
"Yw" = (
/obj/machinery/computer{
	desc = "A computer long since rendered non-functional due to lack of maintenance. Spitting out error messages.";
	dir = 8;
	name = "Broken Computer"
	},
/turf/open/floor/mineral/titanium/white,
/area/ruin/space/has_grav/whiteship/box)

(1,1,1) = {"
EZ
EZ
EZ
EZ
EZ
EZ
EZ
EZ
LS
LS
lw
LS
LS
EZ
EZ
EZ
EZ
EZ
EZ
EZ
EZ
"}
(2,1,1) = {"
EZ
EZ
EZ
EZ
EZ
EZ
EZ
EZ
LS
Ui
Al
Ui
LS
EZ
EZ
EZ
EZ
EZ
EZ
EZ
EZ
"}
(3,1,1) = {"
EZ
EZ
EZ
EZ
EZ
EZ
EZ
EZ
LS
Al
Al
Al
LS
EZ
EZ
EZ
EZ
EZ
EZ
EZ
EZ
"}
(4,1,1) = {"
EZ
EZ
EZ
EZ
EZ
EZ
EZ
EZ
LS
Al
Al
Al
LS
EZ
EZ
EZ
EZ
EZ
EZ
EZ
EZ
"}
(5,1,1) = {"
EZ
EZ
EZ
EZ
EZ
EZ
EZ
EZ
LS
Al
Al
Al
LS
EZ
EZ
EZ
EZ
EZ
EZ
EZ
EZ
"}
(6,1,1) = {"
EZ
EZ
EZ
EZ
EZ
EZ
EZ
EZ
LS
Al
Al
Gv
LS
EZ
EZ
EZ
EZ
EZ
EZ
EZ
EZ
"}
(7,1,1) = {"
EZ
EZ
EZ
EZ
EZ
EZ
EZ
EZ
LS
Al
Al
Al
LS
EZ
EZ
EZ
EZ
EZ
EZ
EZ
EZ
"}
(8,1,1) = {"
EZ
EZ
EZ
EZ
EZ
EZ
EZ
EZ
LS
Al
Al
Al
LS
EZ
EZ
EZ
EZ
EZ
EZ
EZ
EZ
"}
(9,1,1) = {"
EZ
EZ
EZ
EZ
EZ
EZ
EZ
EZ
LS
Al
Al
vq
LS
EZ
EZ
EZ
EZ
EZ
EZ
EZ
EZ
"}
(10,1,1) = {"
EZ
EZ
EZ
EZ
EZ
EZ
EZ
EZ
LS
Ui
Al
Ui
LS
EZ
EZ
EZ
EZ
EZ
EZ
EZ
EZ
"}
(11,1,1) = {"
EZ
EZ
EZ
EZ
EZ
EZ
EZ
EZ
LS
LS
Ip
LS
LS
EZ
EZ
EZ
EZ
EZ
EZ
EZ
EZ
"}
(12,1,1) = {"
EZ
EZ
EZ
EZ
EZ
EZ
EZ
EZ
EZ
LS
Al
LS
EZ
EZ
EZ
EZ
EZ
EZ
EZ
EZ
EZ
"}
(13,1,1) = {"
EZ
EZ
EZ
EZ
EZ
EZ
EZ
EZ
LS
LS
Ip
LS
LS
EZ
EZ
EZ
EZ
EZ
EZ
EZ
EZ
"}
(14,1,1) = {"
EZ
EZ
EZ
EZ
EZ
EZ
EZ
LS
LS
Ui
Al
Ui
LS
LS
EZ
EZ
EZ
EZ
EZ
EZ
EZ
"}
(15,1,1) = {"
LS
kB
ON
ON
ON
Uj
EZ
LS
Ui
Al
Al
Al
Ui
LS
EZ
kB
ON
ON
ON
Uj
LS
"}
(16,1,1) = {"
LS
LS
aj
aj
aj
LS
LS
LS
Mw
Al
Al
Al
Gv
LS
LS
LS
aj
aj
aj
LS
LS
"}
(17,1,1) = {"
EZ
LS
Ui
oF
oF
Ui
LS
Ui
Al
Al
Al
Al
Al
Ui
LS
Ui
oF
oF
Ui
LS
EZ
"}
(18,1,1) = {"
EZ
EZ
LS
Ui
oF
XU
LS
Al
Al
Al
Al
Al
Al
PE
LS
bm
oF
Ui
LS
EZ
EZ
"}
(19,1,1) = {"
EZ
EZ
EZ
LS
LS
lw
LS
LS
LS
Ii
Tv
Ii
LS
LS
LS
lw
LS
LS
EZ
EZ
EZ
"}
(20,1,1) = {"
EZ
EZ
EZ
LS
LS
Al
Al
Al
Al
Al
Al
Al
Al
Al
Al
Al
LS
LS
EZ
EZ
EZ
"}
(21,1,1) = {"
EZ
EZ
LS
LS
Ui
oo
Al
Al
Al
Al
Jy
Al
Al
Al
Al
Al
LS
LS
LS
EZ
EZ
"}
(22,1,1) = {"
EZ
LS
LS
Ui
Al
Al
Al
Al
LS
LS
LS
LS
LS
LS
Al
Al
LS
LS
LS
LS
EZ
"}
(23,1,1) = {"
LS
LS
LS
LS
LS
LS
Ui
Al
LS
QE
Al
yH
Al
Ip
Al
Al
Ip
Al
Ui
LS
EZ
"}
(24,1,1) = {"
lw
Al
Al
JG
JG
Ui
LS
Gv
LS
aL
Al
VL
pl
LS
Mw
Al
LS
Al
TB
LS
LS
"}
(25,1,1) = {"
LS
Al
Al
Al
Al
uW
LS
Al
Ip
Al
zf
Al
Pb
LS
Al
Al
LS
Al
Al
Ui
LS
"}
(26,1,1) = {"
LS
Ko
Al
Al
Al
Al
LS
Al
LS
LS
LS
LS
LS
LS
Al
oo
Ii
Ry
Al
Al
LS
"}
(27,1,1) = {"
LS
VO
Al
Al
Al
Al
Ip
Al
Al
Al
Qn
Al
Al
Al
Al
Al
Ii
Al
Al
mo
LS
"}
(28,1,1) = {"
LS
Al
Al
Al
Al
Al
LS
Ui
Al
Al
Al
Al
Al
Al
Al
kK
Ii
Al
Al
Al
LS
"}
(29,1,1) = {"
LS
Al
Al
Al
Al
Ui
LS
LS
LS
Ii
Tv
Ii
LS
LS
LS
LS
LS
Al
Al
Al
LS
"}
(30,1,1) = {"
LS
Al
Al
Al
Ui
LS
Ui
Al
Al
Al
Al
Al
Al
On
On
On
LS
Al
Al
Ui
LS
"}
(31,1,1) = {"
lw
Al
gs
Al
LS
Ui
Al
Al
Al
Al
Al
Al
Al
Al
Al
Al
Ui
Ui
jo
LS
EZ
"}
(32,1,1) = {"
LS
LS
LS
Mq
LS
HW
nF
Al
Al
Al
Al
Al
Al
Al
Al
LT
dn
LS
LS
LS
EZ
"}
(33,1,1) = {"
EZ
EZ
LS
lm
LS
DB
nF
Al
Al
On
ot
On
Al
Al
Al
Al
Ui
LS
LS
EZ
EZ
"}
(34,1,1) = {"
EZ
EZ
LS
JF
LS
Ui
cZ
Al
Al
Ft
Yw
lk
Al
Al
Al
Ui
LS
LS
EZ
EZ
EZ
"}
(35,1,1) = {"
EZ
EZ
EZ
EZ
LS
LS
LS
Ii
Ii
Ii
Ii
Ii
Ii
Ii
LS
LS
LS
EZ
EZ
EZ
EZ
"}
