//MAP CONVERTED BY dmm2tgm.py THIS HEADER COMMENT PREVENTS RECONVERSION, DO NOT REMOVE
"a" = (
/turf/closed/wall/mineral/titanium,
/area/shuttle/escape)
"b" = (
/obj/structure/shuttle/engine/propulsion{
	dir = 4
	},
/obj/structure/window/reinforced,
/turf/open/floor/plating,
/area/shuttle/escape)
"c" = (
/obj/structure/table/optable,
/obj/machinery/vending/wallmed{
	pixel_x = -28
	},
/turf/open/floor/mineral/titanium,
/area/shuttle/escape)
"d" = (
/obj/effect/spawner/structure/window/shuttle,
/turf/open/floor/plating,
/area/shuttle/escape)
"e" = (
/obj/machinery/door/airlock/titanium{
	name = "Emergency Shuttle Airlock"
	},
/obj/structure/fans/tiny,
/obj/structure/fans/tiny/shield{
	color = "#33FF33";
	name = "Atmospheric/Liquid Forcefield"
	},
/obj/docking_port/mobile/emergency{
	dir = 2;
	width = 15;
	height = 16
	},
/turf/open/floor/plating,
/area/shuttle/escape)
"f" = (
/obj/structure/chair/comfy/shuttle{
	dir = 4
	},
/turf/open/floor/mineral/plastitanium/red/brig,
/area/shuttle/escape)
"h" = (
/obj/structure/chair/comfy/shuttle{
	dir = 8
	},
/turf/open/floor/mineral/titanium/yellow,
/area/shuttle/escape)
"i" = (
/obj/machinery/sleeper{
	dir = 8
	},
/turf/open/floor/mineral/titanium,
/area/shuttle/escape)
"j" = (
/obj/structure/shuttle/engine/propulsion{
	dir = 4
	},
/turf/open/floor/plating,
/area/shuttle/escape)
"k" = (
/obj/structure/shuttle/engine/heater{
	dir = 8
	},
/obj/structure/window/reinforced,
/turf/open/floor/plating,
/area/shuttle/escape)
"l" = (
/obj/machinery/computer/emergency_shuttle{
	dir = 4
	},
/turf/open/floor/mineral/titanium/yellow,
/area/shuttle/escape)
"o" = (
/obj/structure/chair/comfy/teal{
	dir = 8
	},
/turf/open/floor/mineral/titanium/yellow,
/area/shuttle/escape)
"p" = (
/obj/structure/chair/comfy/shuttle{
	dir = 8
	},
/turf/open/floor/mineral/titanium/blue,
/area/shuttle/escape)
"q" = (
/obj/machinery/door/airlock/public/glass{
	name = "Emergency Shuttle Cockpit";
	req_access_txt = "19"
	},
/turf/open/floor/mineral/titanium/yellow,
/area/shuttle/escape)
"r" = (
/obj/structure/chair/comfy/shuttle,
/turf/open/floor/mineral/titanium,
/area/shuttle/escape)
"s" = (
/obj/machinery/light/floor,
/turf/open/floor/mineral/plastitanium/red/brig,
/area/shuttle/escape)
"t" = (
/obj/structure/table/reinforced,
/obj/item/storage/toolbox/emergency,
/obj/structure/window/reinforced{
	dir = 4
	},
/turf/open/floor/mineral/titanium/yellow,
/area/shuttle/escape)
"v" = (
/obj/structure/table/reinforced,
/obj/item/radio,
/obj/structure/window/reinforced{
	dir = 8
	},
/turf/open/floor/mineral/titanium/yellow,
/area/shuttle/escape)
"w" = (
/obj/machinery/status_display/evac,
/turf/closed/wall/mineral/titanium,
/area/shuttle/escape)
"x" = (
/obj/structure/table/reinforced,
/obj/item/storage/firstaid/regular,
/obj/structure/window/reinforced{
	dir = 8
	},
/turf/open/floor/mineral/titanium/yellow,
/area/shuttle/escape)
"y" = (
/obj/structure/shuttle/engine/heater{
	dir = 8
	},
/obj/structure/window/reinforced{
	dir = 1
	},
/turf/open/floor/plating,
/area/shuttle/escape)
"z" = (
/obj/structure/shuttle/engine/heater{
	dir = 8
	},
/obj/structure/window/reinforced{
	dir = 4
	},
/turf/open/floor/plating,
/area/shuttle/escape)
"A" = (
/turf/open/floor/mineral/titanium/blue,
/area/shuttle/escape)
"B" = (
/obj/machinery/light/floor,
/turf/open/floor/mineral/titanium,
/area/shuttle/escape)
"C" = (
/obj/structure/shuttle/engine/propulsion{
	dir = 4
	},
/obj/structure/window/reinforced{
	dir = 1
	},
/turf/open/floor/plating,
/area/shuttle/escape)
"E" = (
/obj/structure/chair/comfy/shuttle{
	dir = 4
	},
/turf/open/floor/mineral/titanium/yellow,
/area/shuttle/escape)
"G" = (
/turf/open/floor/mineral/titanium/yellow,
/area/shuttle/escape)
"I" = (
/turf/open/floor/mineral/titanium,
/area/shuttle/escape)
"J" = (
/obj/structure/table,
/obj/item/storage/backpack/duffelbag/med/surgery,
/turf/open/floor/mineral/titanium,
/area/shuttle/escape)
"L" = (
/turf/template_noop,
/area/template_noop)
"M" = (
/obj/machinery/door/airlock/titanium{
	name = "Emergency Shuttle Airlock"
	},
/obj/structure/fans/tiny,
/obj/structure/fans/tiny/shield{
	color = "#33FF33";
	name = "Atmospheric/Liquid Forcefield"
	},
/turf/open/floor/plating,
/area/shuttle/escape)
"N" = (
/obj/structure/chair/comfy/shuttle{
	dir = 4
	},
/turf/open/floor/mineral/titanium/blue,
/area/shuttle/escape)
"O" = (
/obj/structure/table,
/turf/open/floor/mineral/titanium,
/area/shuttle/escape)
"P" = (
/obj/machinery/door/airlock/public/glass{
	name = "Emergency Shuttle Infirmary"
	},
/turf/open/floor/mineral/titanium/blue,
/area/shuttle/escape)
"Q" = (
/turf/open/floor/mineral/plastitanium/red/brig,
/area/shuttle/escape)
"S" = (
/obj/machinery/light/floor,
/turf/open/floor/mineral/titanium/yellow,
/area/shuttle/escape)
"T" = (
/obj/machinery/light/floor,
/turf/open/floor/mineral/titanium/blue,
/area/shuttle/escape)
"V" = (
/obj/structure/shuttle/engine/propulsion{
	dir = 4
	},
/turf/open/space/basic,
/area/shuttle/escape)
"W" = (
/obj/structure/chair/comfy/shuttle{
	dir = 8
	},
/turf/open/floor/mineral/plastitanium/red/brig,
/area/shuttle/escape)
"X" = (
/obj/machinery/door/airlock/public/glass{
	name = "Emergency Shuttle Brig";
	req_access_txt = "2"
	},
/turf/open/floor/mineral/titanium/blue,
/area/shuttle/escape)
"Y" = (
/turf/closed/wall/mineral/titanium/nodiagonal,
/area/shuttle/escape)
"Z" = (
/obj/structure/table/reinforced,
/obj/item/storage/firstaid/regular,
/obj/structure/window/reinforced{
	dir = 4
	},
/turf/open/floor/mineral/titanium/yellow,
/area/shuttle/escape)

(1,1,1) = {"
L
L
L
j
j
j
L
L
L
V
j
j
L
L
L
"}
(2,1,1) = {"
C
a
a
z
z
z
a
a
a
z
z
z
a
a
b
"}
(3,1,1) = {"
y
a
r
I
I
I
c
a
f
f
Q
f
f
a
k
"}
(4,1,1) = {"
Y
a
O
i
B
i
J
a
W
Q
s
Q
W
a
Y
"}
(5,1,1) = {"
a
a
a
a
P
a
a
w
a
a
X
a
a
a
a
"}
(6,1,1) = {"
a
a
N
N
A
N
N
N
N
N
A
N
N
N
a
"}
(7,1,1) = {"
d
N
N
A
T
A
A
A
A
A
T
A
N
N
d
"}
(8,1,1) = {"
a
N
N
A
Y
d
a
a
a
d
Y
A
N
N
a
"}
(9,1,1) = {"
e
A
A
A
a
x
E
l
E
v
a
A
A
A
M
"}
(10,1,1) = {"
d
A
A
A
q
S
G
G
G
S
q
A
A
A
d
"}
(11,1,1) = {"
M
A
A
A
a
t
h
o
h
Z
a
A
A
A
M
"}
(12,1,1) = {"
a
p
p
A
Y
d
a
w
a
d
Y
A
p
p
a
"}
(13,1,1) = {"
d
p
p
A
A
N
N
N
N
N
A
A
p
p
d
"}
(14,1,1) = {"
a
a
p
T
A
A
A
A
A
A
A
T
p
a
a
"}
(15,1,1) = {"
a
a
a
p
p
p
p
p
p
p
p
p
a
a
a
"}
(16,1,1) = {"
L
a
a
a
d
d
d
a
d
d
d
a
a
a
L
"}
