"a" = (/turf/closed/wall/mineral/titanium,/area/shuttle/escape)
"b" = (/obj/structure/shuttle/engine/propulsion{dir = 4},/obj/structure/window/reinforced,/turf/open/floor/plating,/area/shuttle/escape)
"c" = (/obj/structure/table/optable,/obj/machinery/vending/wallmed{pixel_x = -28},/turf/open/floor/mineral/titanium,/area/shuttle/escape)
"d" = (/obj/effect/spawner/structure/window/shuttle,/turf/open/floor/plating,/area/shuttle/escape)
"f" = (/obj/structure/chair/comfy/shuttle{dir = 4},/turf/open/floor/mineral/plastitanium/red/brig,/area/shuttle/escape)
"h" = (/obj/structure/chair/comfy/shuttle{dir = 8},/turf/open/floor/mineral/titanium/yellow,/area/shuttle/escape)
"i" = (/obj/machinery/sleeper{dir = 8},/turf/open/floor/mineral/titanium,/area/shuttle/escape)
"j" = (/obj/structure/shuttle/engine/propulsion{dir = 4},/turf/open/floor/plating,/area/shuttle/escape)
"k" = (/obj/structure/shuttle/engine/heater{dir = 8},/obj/structure/window/reinforced,/turf/open/floor/plating,/area/shuttle/escape)
"l" = (/obj/machinery/computer/emergency_shuttle{dir = 4},/turf/open/floor/mineral/titanium/yellow,/area/shuttle/escape)
"o" = (/obj/structure/chair/comfy/teal{dir = 8},/turf/open/floor/mineral/titanium/yellow,/area/shuttle/escape)
"p" = (/obj/structure/chair/comfy/shuttle{dir = 8},/turf/open/floor/mineral/titanium/blue,/area/shuttle/escape)
"q" = (/obj/machinery/door/airlock/public/glass{name = "Emergency Shuttle Cockpit"; req_access_txt = "19"},/turf/open/floor/mineral/titanium/yellow,/area/shuttle/escape)
"r" = (/obj/structure/chair/comfy/shuttle,/turf/open/floor/mineral/titanium,/area/shuttle/escape)
"s" = (/obj/machinery/light/floor,/turf/open/floor/mineral/plastitanium/red/brig,/area/shuttle/escape)
"t" = (/obj/structure/table/reinforced,/obj/item/storage/toolbox/emergency,/obj/structure/window/reinforced{dir = 4},/turf/open/floor/mineral/titanium/yellow,/area/shuttle/escape)
"v" = (/obj/structure/table/reinforced,/obj/item/radio,/obj/structure/window/reinforced{dir = 8},/turf/open/floor/mineral/titanium/yellow,/area/shuttle/escape)
"w" = (/obj/machinery/status_display/evac,/turf/closed/wall/mineral/titanium,/area/shuttle/escape)
"x" = (/obj/structure/table/reinforced,/obj/item/storage/firstaid/regular,/obj/structure/window/reinforced{dir = 8},/turf/open/floor/mineral/titanium/yellow,/area/shuttle/escape)
"y" = (/obj/structure/shuttle/engine/heater{dir = 8},/obj/structure/window/reinforced{dir = 1},/turf/open/floor/plating,/area/shuttle/escape)
"z" = (/obj/structure/shuttle/engine/heater{dir = 8},/obj/structure/window/reinforced{dir = 4},/turf/open/floor/plating,/area/shuttle/escape)
"A" = (/turf/open/floor/mineral/titanium/blue,/area/shuttle/escape)
"B" = (/obj/machinery/light/floor,/turf/open/floor/mineral/titanium,/area/shuttle/escape)
"C" = (/obj/structure/shuttle/engine/propulsion{dir = 4},/obj/structure/window/reinforced{dir = 1},/turf/open/floor/plating,/area/shuttle/escape)
"E" = (/obj/structure/chair/comfy/shuttle{dir = 4},/turf/open/floor/mineral/titanium/yellow,/area/shuttle/escape)
"G" = (/turf/open/floor/mineral/titanium/yellow,/area/shuttle/escape)
"I" = (/turf/open/floor/mineral/titanium,/area/shuttle/escape)
"J" = (/obj/structure/table,/obj/item/storage/backpack/duffelbag/med/surgery,/turf/open/floor/mineral/titanium,/area/shuttle/escape)
"L" = (/turf/template_noop,/area/template_noop)
"M" = (/obj/machinery/door/airlock/titanium{name = "Emergency Shuttle Airlock"},/obj/structure/fans/tiny,/obj/structure/fans/tiny/shield{color = "#33FF33"; name = "Atmospheric/Liquid Forcefield"},/turf/open/floor/plating,/area/shuttle/escape)
"N" = (/obj/structure/chair/comfy/shuttle{dir = 4},/turf/open/floor/mineral/titanium/blue,/area/shuttle/escape)
"O" = (/obj/structure/table,/turf/open/floor/mineral/titanium,/area/shuttle/escape)
"P" = (/obj/machinery/door/airlock/public/glass{name = "Emergency Shuttle Infirmary"},/turf/open/floor/mineral/titanium/blue,/area/shuttle/escape)
"Q" = (/turf/open/floor/mineral/plastitanium/red/brig,/area/shuttle/escape)
"S" = (/obj/machinery/light/floor,/turf/open/floor/mineral/titanium/yellow,/area/shuttle/escape)
"T" = (/obj/machinery/light/floor,/turf/open/floor/mineral/titanium/blue,/area/shuttle/escape)
"V" = (/obj/structure/shuttle/engine/propulsion{dir = 4},/turf/open/space/basic,/area/shuttle/escape)
"W" = (/obj/structure/chair/comfy/shuttle{dir = 8},/turf/open/floor/mineral/plastitanium/red/brig,/area/shuttle/escape)
"X" = (/obj/machinery/door/airlock/public/glass{name = "Emergency Shuttle Brig"; req_access_txt = "2"},/turf/open/floor/mineral/titanium/blue,/area/shuttle/escape)
"Y" = (/turf/closed/wall/mineral/titanium/nodiagonal,/area/shuttle/escape)
"Z" = (/obj/structure/table/reinforced,/obj/item/storage/firstaid/regular,/obj/structure/window/reinforced{dir = 4},/turf/open/floor/mineral/titanium/yellow,/area/shuttle/escape)

(1,1,1) = {"
LCyYaadaMdMadaaL
LaaaaaNNAAAppaaa
LarOaNNNAAApppaa
jzIiaNAAAAAAATpa
jzIBPATYaqaYAApd
jzIiaNAdxStdNApd
LacJaNAaEGhaNApd
LaaawNAalGowNApa
LafWaNAaEGhaNApd
VzfQaNAdvSZdNApd
jzQsXATYaqaYAApd
jzfQaNAAAAAAATpa
LafWaNNNAAApppaa
LaaaaNNNAAAppaaa
LbkYaadaMdMadaaL
"}
